plutommi\Customer\CustResource\CustAdoDataHW.h	plutommi\MMI\Resource\WriteRes.c
plutommi\Customer\CustResource\CustAdoDataHWExt.h	plutommi\MMI\Resource\WriteRes.c
plutommi\Customer\CustResource\CustAdoMap.c	plutommi\MMI\Resource\WriteRes.c
plutommi\Customer\CustResource\CustAdoMapExt.c	plutommi\MMI\Resource\WriteRes.c
plutommi\Customer\CustResource\CustAdoRes.c	plutommi\MMI\Resource\WriteRes.c
plutommi\Customer\CustResource\CustAdoResExt.c	plutommi\MMI\Resource\WriteRes.c
plutommi\Customer\CustResource\CustBLImgData.h	plutommi\MMI\Resource\WriteRes.c
plutommi\Customer\CustResource\CustBinaryDataHW.h	plutommi\MMI\Resource\WriteRes.c
plutommi\Customer\CustResource\CustBinaryMap.c	plutommi\MMI\Resource\WriteRes.c
plutommi\Customer\CustResource\CustBinaryRes.c	plutommi\MMI\Resource\WriteRes.c
plutommi\Customer\CustResource\CustENFBImgMap.c	plutommi\MMI\Resource\WriteRes.c
plutommi\Customer\CustResource\CustFOTAImgData.h	plutommi\MMI\Resource\WriteRes.c
plutommi\Customer\CustResource\CustFontDataHW.h	plutommi\MMI\Resource\WriteRes.c
plutommi\Customer\CustResource\CustFontMapExt.c	plutommi\MMI\Resource\WriteRes.c
plutommi\Customer\CustResource\CustFontResExt.c	plutommi\MMI\Resource\WriteRes.c
plutommi\Customer\CustResource\CustGameDataHW.h	plutommi\MMI\Resource\WriteRes.c
plutommi\Customer\CustResource\CustImgDataHW.h	plutommi\MMI\Resource\WriteRes.c
plutommi\Customer\CustResource\CustImgDataHWExt.h	plutommi\MMI\Resource\WriteRes.c
plutommi\Customer\CustResource\CustImgMap.c	plutommi\MMI\Resource\WriteRes.c
plutommi\Customer\CustResource\CustImgMapExt.c	plutommi\MMI\Resource\WriteRes.c
plutommi\Customer\CustResource\CustImgRes.c	plutommi\MMI\Resource\WriteRes.c
plutommi\Customer\CustResource\CustImgResExt.c	plutommi\MMI\Resource\WriteRes.c
plutommi\Customer\CustResource\CustMenuRes.c	plutommi\MMI\Resource\WriteRes.c
plutommi\Customer\CustResource\CustNFBProgressImg.c	plutommi\MMI\Resource\WriteRes.c
plutommi\Customer\CustResource\CustNFBProgressImg.h	plutommi\MMI\Resource\WriteRes.c
plutommi\Customer\CustResource\CustStrMap.c	plutommi\MMI\Resource\WriteRes.c
plutommi\Customer\CustResource\CustStrRes.c	plutommi\MMI\Resource\WriteRes.c
plutommi\Customer\CustResource\CustVenusThemeData.h	plutommi\Customer\ResGenerator\venus_theme_generator.pl
plutommi\Customer\CustResource\CustVenusThemeId.h	plutommi\Customer\ResGenerator\venus_theme_generator.pl
plutommi\Customer\CustResource\CustWebcamImgData.h	plutommi\MMI\Resource\WriteRes.c
plutommi\Customer\CustResource\fontres.c	vendor\font\MTK\official\project\plutommi\content\src\MainLcd128X128\res_gen_font.cpp
plutommi\Customer\CustResource\mmi_rp_img_misc_data.c	plutommi\Customer\ResGenerator\ResgenXML\ResgenSrc\mmi_rp_image.c
plutommi\Customer\CustResource\mmi_rp_menu_misc_data.c	plutommi\Customer\ResGenerator\ResgenXML\ResgenSrc\mmi_rp_menu.c
plutommi\Customer\CustResource\mmi_rp_menu_shortcut_data.c	plutommi\Customer\ResGenerator\ResgenXML\ResgenSrc\mmi_rp_menu.c
plutommi\Customer\CustResource\mmi_rp_native_app_package_data.c	plutommi\Customer\ResGenerator\ResgenXML\ResgenSrc\mmi_rp_xml.c
plutommi\Customer\CustResource\mte_img_resource.h	plutommi\Customer\ResGenerator\mte_excel_gen.pl
plutommi\Customer\CustomerInc\mmi_rp_app_alarm_def.h	plutommi\mmi\organizer\organizerres\alarmres\alarm.res
plutommi\Customer\CustomerInc\mmi_rp_app_am_def.h	plutommi\mtkapp\mreapp\mreappres\am_int.res
plutommi\Customer\CustomerInc\mmi_rp_app_apn_control_def.h	plutommi\mmi\setting\settingres\apncontrol.res
plutommi\Customer\CustomerInc\mmi_rp_app_appmgr_test_1_def.h	plutommi\service\nativeappfactorysrv\nativeappfactorysrvres\app_appmgr_test_1.res
plutommi\Customer\CustomerInc\mmi_rp_app_appmgr_test_2_def.h	app_appmgr_test_2.res
plutommi\Customer\CustomerInc\mmi_rp_app_appmgr_test_3_def.h	app_appmgr_test_3.res
plutommi\Customer\CustomerInc\mmi_rp_app_appmgr_test_4_def.h	app_appmgr_test_4.res
plutommi\Customer\CustomerInc\mmi_rp_app_audioplayer_def.h	plutommi\mtkapp\audioplayer\audioplayerres\audioplayer.res
plutommi\Customer\CustomerInc\mmi_rp_app_auto_rotate_def.h	screenrotation.res
plutommi\Customer\CustomerInc\mmi_rp_app_bluetooth_def.h	plutommi\mtkapp\connectivity\connectivityres\bluetooth\bluetooth.res
plutommi\Customer\CustomerInc\mmi_rp_app_bootup_def.h	plutommi\mmi\bootup\bootupres\bootup.res
plutommi\Customer\CustomerInc\mmi_rp_app_bt_dialer_def.h	plutommi\mtkapp\btdialer\btdialerres\btdialer.res
plutommi\Customer\CustomerInc\mmi_rp_app_calculator_def.h	plutommi\mmi\extra\extrares\calculator.res
plutommi\Customer\CustomerInc\mmi_rp_app_calendar_def.h	plutommi\mmi\organizer\organizerres\calendar.res
plutommi\Customer\CustomerInc\mmi_rp_app_calibration_def.h	plutommi\mmi\setting\settingres\pencalibration\calibration.res
plutommi\Customer\CustomerInc\mmi_rp_app_calllog_def.h	plutommi\mmi\calllog\calllogres\calllog.res
plutommi\Customer\CustomerInc\mmi_rp_app_callset_def.h	plutommi\mmi\callsetting\callsettingres\callset.res
plutommi\Customer\CustomerInc\mmi_rp_app_camco_def.h	plutommi\mtkapp\camcorder\camcorderres\camcorder.res
plutommi\Customer\CustomerInc\mmi_rp_app_camera_def.h	plutommi\mtkapp\camera\camerares\camerares.res
plutommi\Customer\CustomerInc\mmi_rp_app_cb_mgr_def.h	plutommi\framework\callbackmanager\callbackmanagerres\callback_mgr.res
plutommi\Customer\CustomerInc\mmi_rp_app_cbm_def.h	plutommi\mmi\cbm\cbmres\cbm.res
plutommi\Customer\CustomerInc\mmi_rp_app_charger_def.h	plutommi\mmi\miscframework\miscframeworkres\chargerapp.res
plutommi\Customer\CustomerInc\mmi_rp_app_connectivity_mainmenu_def.h	plutommi\mtkapp\connectivity\connectivityres\connectivitymainmenu.res
plutommi\Customer\CustomerInc\mmi_rp_app_customer_service_def.h	plutommi\mmi\customerservice\customerserviceres\customerservice.res
plutommi\Customer\CustomerInc\mmi_rp_app_dataaccount_def.h	plutommi\mmi\dataaccount\dataaccountres\dataaccount.res
plutommi\Customer\CustomerInc\mmi_rp_app_devapp_def.h	plutommi\vendorapp\devapp\devappres\devapp.res
plutommi\Customer\CustomerInc\mmi_rp_app_dialer_def.h	plutommi\mmi\dialer\dialerres\dialer.res
plutommi\Customer\CustomerInc\mmi_rp_app_engineermode1_def.h	plutommi\mtkapp\engineermode\engineermodeapp\engineermodeappres\engineermode.res
plutommi\Customer\CustomerInc\mmi_rp_app_extra_def.h	plutommi\mmi\extra\extrares\extra.res
plutommi\Customer\CustomerInc\mmi_rp_app_factorymode_def.h	plutommi\mtkapp\factorymode\factorymoderes\factorymode.res
plutommi\Customer\CustomerInc\mmi_rp_app_filemanager_def.h	plutommi\mtkapp\filemgr\filemgrres\000_filemgr.res
plutommi\Customer\CustomerInc\mmi_rp_app_font_effects_def.h	plutommi\mmi\miscframework\miscframeworkres\fonteffects.res
plutommi\Customer\CustomerInc\mmi_rp_app_font_manager_def.h	plutommi\mmi\miscframework\miscframeworkres\fontmanager.res
plutommi\Customer\CustomerInc\mmi_rp_app_funandgames_def.h	plutommi\mmi\funandgames\funandgamesres\fanandgame.res
plutommi\Customer\CustomerInc\mmi_rp_app_gpio_def.h	plutommi\mmi\gpio\gpiores\phnsetgpio.res
plutommi\Customer\CustomerInc\mmi_rp_app_idle_def.h	plutommi\mmi\idle\idleres\idle.res
plutommi\Customer\CustomerInc\mmi_rp_app_idle_homescreen_def.h	plutommi\mmi\idlescreen\idlescreenres\idlehomescreen.res
plutommi\Customer\CustomerInc\mmi_rp_app_idle_nmgr_def.h	plutommi\mmi\idlescreen\idlescreenres\idlenotificationmanager.res
plutommi\Customer\CustomerInc\mmi_rp_app_imageflow_def.h	venusmmi\app\pluto_variation\imageflow\res\imageflow.res
plutommi\Customer\CustomerInc\mmi_rp_app_imageviewer_def.h	plutommi\mtkapp\imageview\imageviewres\imgview.res
plutommi\Customer\CustomerInc\mmi_rp_app_lunar_query_def.h	plutommi\mmi\organizer\organizerres\lunarquery.res
plutommi\Customer\CustomerInc\mmi_rp_app_mainmenu_def.h	plutommi\mmi\mainmenu\mainmenures\mainmenures.res
plutommi\Customer\CustomerInc\mmi_rp_app_mediawall_def.h	venusmmi\app\pluto_variation\mediawall\res\mediawall.res
plutommi\Customer\CustomerInc\mmi_rp_app_mmi_certman_def.h	plutommi\mmi\certificatemanager\certificatemanagerres\certificatemanager.res
plutommi\Customer\CustomerInc\mmi_rp_app_mobile_service_def.h	plutommi\mmi\mobileservice\mobileserviceres\mobileservice.res
plutommi\Customer\CustomerInc\mmi_rp_app_mode_switch_def.h	plutommi\mmi\setting\settingres\modeswitch.res
plutommi\Customer\CustomerInc\mmi_rp_app_mre_appmgr_def.h	plutommi\service\mreappmgrsrv\mreappmgrsrvres\mreappmgrsrv.res
plutommi\Customer\CustomerInc\mmi_rp_app_mre_bg_def.h	mre\res\mre_bg.res
plutommi\Customer\CustomerInc\mmi_rp_app_mre_def.h	mre\res\mre.res
plutommi\Customer\CustomerInc\mmi_rp_app_mspace_def.h	plutommi\mtkapp\mspace\mspaceres\mspace.res
plutommi\Customer\CustomerInc\mmi_rp_app_netset_def.h	plutommi\mmi\setting\settingres\netsetapp.res
plutommi\Customer\CustomerInc\mmi_rp_app_nitz_def.h	plutommi\mmi\nitzhandler\nitzres\nitz.res
plutommi\Customer\CustomerInc\mmi_rp_app_note_def.h	plutommi\mmi\organizer\organizerres\note.res
plutommi\Customer\CustomerInc\mmi_rp_app_nss_def.h	plutommi\mmi\setting\settingres\nssapp.res
plutommi\Customer\CustomerInc\mmi_rp_app_ntp_def.h	plutommi\mmi\setting\settingres\ntpapp.res
plutommi\Customer\CustomerInc\mmi_rp_app_nw_info_def.h	plutommi\mmi\nwinfo\nwinfores\nwinfo.res
plutommi\Customer\CustomerInc\mmi_rp_app_organizer_def.h	plutommi\mmi\organizer\organizerres\organizer.res
plutommi\Customer\CustomerInc\mmi_rp_app_package_concurrent_def.h	plutommi\mmi\inc\app_package_concurrent.res
plutommi\Customer\CustomerInc\mmi_rp_app_phonebook_def.h	plutommi\mmi\phonebook\phonebookres\phonebook.res
plutommi\Customer\CustomerInc\mmi_rp_app_phonesetting_new_def.h	plutommi\mmi\setting\settingres\phonesetting.res
plutommi\Customer\CustomerInc\mmi_rp_app_profiles_def.h	plutommi\mmi\profiles\profiles_res\profiles.res
plutommi\Customer\CustomerInc\mmi_rp_app_reminder_def.h	plutommi\mmi\organizer\reminder\res\reminder.res
plutommi\Customer\CustomerInc\mmi_rp_app_restore_def.h	plutommi\mmi\setting\settingres\restore.res
plutommi\Customer\CustomerInc\mmi_rp_app_sat_def.h	plutommi\mmi\sat\satres\satapp.res
plutommi\Customer\CustomerInc\mmi_rp_app_scr_locker_def.h	plutommi\mmi\scrlocker\scrlockerres\scrlocker.res
plutommi\Customer\CustomerInc\mmi_rp_app_search_web_def.h	plutommi\mtkapp\searchweb\searchwebres\searchweb.res
plutommi\Customer\CustomerInc\mmi_rp_app_security_setting_def.h	plutommi\mmi\securitysetting\secsetres\secset.res
plutommi\Customer\CustomerInc\mmi_rp_app_services_sat_def.h	plutommi\mmi\sat\satres\service.res
plutommi\Customer\CustomerInc\mmi_rp_app_setting_download_cal_data_def.h	plutommi\mmi\setting\settingres\downloadcaldata.res
plutommi\Customer\CustomerInc\mmi_rp_app_setting_menu_effect_def.h	plutommi\mmi\setting\settingres\menueffect.res
plutommi\Customer\CustomerInc\mmi_rp_app_setting_new_def.h	plutommi\mmi\setting\settingres\appsetting.res
plutommi\Customer\CustomerInc\mmi_rp_app_setting_version_def.h	plutommi\mmi\setting\settingres\version.res
plutommi\Customer\CustomerInc\mmi_rp_app_shellapp_base_def.h	venusmmi\app\pluto_variation\shellapp\base\res\shellappbase.res
plutommi\Customer\CustomerInc\mmi_rp_app_shortcuts_def.h	plutommi\mmi\extra\extrares\shortcuts.res
plutommi\Customer\CustomerInc\mmi_rp_app_shutdown_def.h	plutommi\mmi\shutdown\shutdownres\shutdown.res
plutommi\Customer\CustomerInc\mmi_rp_app_sim_ctrl_def.h	plutommi\mmi\simctrl\simctrlres\simctrl.res
plutommi\Customer\CustomerInc\mmi_rp_app_simspace_def.h	plutommi\mmi\simspace\simspaceres\simspace.res
plutommi\Customer\CustomerInc\mmi_rp_app_sms_def.h	plutommi\mmi\messages\messagesres\smsappres.res
plutommi\Customer\CustomerInc\mmi_rp_app_soundrecorder_def.h	plutommi\mtkapp\sndrec\sndrecres\sndrec.res
plutommi\Customer\CustomerInc\mmi_rp_app_ss_def.h	plutommi\mmi\supplementaryservice\ssres\ss.res
plutommi\Customer\CustomerInc\mmi_rp_app_sso_def.h	plutommi\mmi\ssoapp\ssoappres\ssoapp.res
plutommi\Customer\CustomerInc\mmi_rp_app_syncml_def.h	plutommi\mtkapp\syncml\syncmlres\syncmldevice.res
plutommi\Customer\CustomerInc\mmi_rp_app_todolist_def.h	plutommi\mmi\organizer\organizerres\todolist.res
plutommi\Customer\CustomerInc\mmi_rp_app_tts_setting_def.h	plutommi\mmi\setting\settingres\ttssetting.res
plutommi\Customer\CustomerInc\mmi_rp_app_ucm_def.h	plutommi\mmi\ucm\ucmres\ucm.res
plutommi\Customer\CustomerInc\mmi_rp_app_ucmbt_def.h	plutommi\mmi\bt_ucm\ucmbtres\ucmbt.res
plutommi\Customer\CustomerInc\mmi_rp_app_udx_def.h	plutommi\mmi\udx\udxres\udx.res
plutommi\Customer\CustomerInc\mmi_rp_app_uiframework_def.h	plutommi\framework\gui\gui_res\gui.res
plutommi\Customer\CustomerInc\mmi_rp_app_unifiedmessage_def.h	plutommi\mmi\unifiedmessage\unifiedmessageres\unifiedmessage.res
plutommi\Customer\CustomerInc\mmi_rp_app_usbmmi_def.h	plutommi\mtkapp\connectivity\connectivityres\usb\usbmmi.res
plutommi\Customer\CustomerInc\mmi_rp_app_usbsrv_def.h	plutommi\service\usbsrv\usbsrvres\usbsrv.res
plutommi\Customer\CustomerInc\mmi_rp_app_vdorec_def.h	plutommi\mtkapp\video\videores\vdorecres.res
plutommi\Customer\CustomerInc\mmi_rp_app_venus_homescreen_def.h	venusmmi\app\pluto_variation\shellapp\panel\homescreen\res\vapp_hs.res
plutommi\Customer\CustomerInc\mmi_rp_app_venus_homescreen_wg_audioplayer_def.h	venusmmi\app\pluto_variation\shellapp\panel\homescreen\res\vapp_hs_widget_audplayer.res
plutommi\Customer\CustomerInc\mmi_rp_app_venus_homescreen_wg_calendar_def.h	venusmmi\app\pluto_variation\shellapp\panel\homescreen\res\vapp_hs_widget_calendar.res
plutommi\Customer\CustomerInc\mmi_rp_app_venus_homescreen_wg_clock_def.h	venusmmi\app\pluto_variation\shellapp\panel\homescreen\res\vapp_hs_widget_clock.res
plutommi\Customer\CustomerInc\mmi_rp_app_venus_homescreen_wg_date_def.h	venusmmi\app\pluto_variation\shellapp\panel\homescreen\res\vapp_hs_widget_date.res
plutommi\Customer\CustomerInc\mmi_rp_app_venus_homescreen_wg_event_inbox_def.h	venusmmi\app\pluto_variation\shellapp\panel\homescreen\res\vapp_hs_widget_event_inbox.res
plutommi\Customer\CustomerInc\mmi_rp_app_venus_homescreen_wg_fmradio_def.h	venusmmi\app\pluto_variation\shellapp\panel\homescreen\res\vapp_hs_widget_fmradio.res
plutommi\Customer\CustomerInc\mmi_rp_app_venus_homescreen_wg_memo_def.h	venusmmi\app\pluto_variation\shellapp\panel\homescreen\res\vapp_hs_widget_memo.res
plutommi\Customer\CustomerInc\mmi_rp_app_venus_homescreen_wg_mobile_internet_def.h	venusmmi\app\pluto_variation\shellapp\panel\homescreen\res\vapp_hs_widget_op02.res
plutommi\Customer\CustomerInc\mmi_rp_app_venus_homescreen_wg_mre_def.h	venusmmi\app\pluto_variation\shellapp\panel\homescreen\res\vapp_hs_widget_mre.res
plutommi\Customer\CustomerInc\mmi_rp_app_venus_homescreen_wg_next_alarm_def.h	venusmmi\app\pluto_variation\shellapp\panel\homescreen\res\vapp_hs_widget_next_alarm.res
plutommi\Customer\CustomerInc\mmi_rp_app_venus_homescreen_wg_operator_name_def.h	venusmmi\app\pluto_variation\shellapp\panel\homescreen\res\vapp_hs_widget_operator_name.res
plutommi\Customer\CustomerInc\mmi_rp_app_venus_homescreen_wg_pet_def.h	venusmmi\app\pluto_variation\shellapp\panel\homescreen\res\vapp_hs_widget_pet.res
plutommi\Customer\CustomerInc\mmi_rp_app_venus_homescreen_wg_photo_def.h	venusmmi\app\pluto_variation\shellapp\panel\homescreen\res\vapp_hs_widget_photo.res
plutommi\Customer\CustomerInc\mmi_rp_app_venus_homescreen_wg_profile_def.h	venusmmi\app\pluto_variation\shellapp\panel\homescreen\res\vapp_hs_widget_profile.res
plutommi\Customer\CustomerInc\mmi_rp_app_venus_homescreen_wg_snow_def.h	venusmmi\app\pluto_variation\shellapp\panel\homescreen\res\vapp_hs_widget_snow.res
plutommi\Customer\CustomerInc\mmi_rp_app_venus_homescreen_wg_wo_store_def.h	venusmmi\app\pluto_variation\shellapp\panel\homescreen\res\vapp_hs_widget_op02.res
plutommi\Customer\CustomerInc\mmi_rp_app_venus_hs_todo_def.h	venusmmi\app\pluto_variation\shellapp\panel\homescreen\res\vapp_hs_widget_todo.res
plutommi\Customer\CustomerInc\mmi_rp_app_venus_hs_wg_baidu_def.h	venusmmi\app\pluto_variation\shellapp\panel\homescreen\res\vapp_hs_widget_baidu.res
plutommi\Customer\CustomerInc\mmi_rp_app_venus_hs_wg_bkm_def.h	venusmmi\app\pluto_variation\shellapp\panel\homescreen\res\vapp_hs_widget_bookmark.res
plutommi\Customer\CustomerInc\mmi_rp_app_venus_notepaper_def.h	venusmmi\app\pluto_variation\shellapp\panel\msgviewer\res\vapp_notepaper.res
plutommi\Customer\CustomerInc\mmi_rp_app_venus_shell_fc_def.h	venusmmi\app\pluto_variation\shellapp\panel\favoritecontacts\res\vapp_shell_fc.res
plutommi\Customer\CustomerInc\mmi_rp_app_venus_shell_iv_def.h	venusmmi\app\pluto_variation\shellapp\panel\imageviewer\res\shellimageviewer.res
plutommi\Customer\CustomerInc\mmi_rp_app_venus_shell_mediaplayer_def.h	venusmmi\app\pluto_variation\shellapp\panel\mediaplayer\vapp_shell_mediaplayer.res
plutommi\Customer\CustomerInc\mmi_rp_app_venus_shell_msg_viewer_def.h	venusmmi\app\pluto_variation\shellapp\panel\msgviewer\res\vapp_shell_msg_viewer.res
plutommi\Customer\CustomerInc\mmi_rp_app_venus_shell_scrlock_def.h	venusmmi\app\pluto_variation\shellapp\base\res\shellappscrlock.res
plutommi\Customer\CustomerInc\mmi_rp_app_venus_shell_settings_def.h	venusmmi\app\pluto_variation\shellapp\panel\settings\vapp_shell_settings.res
plutommi\Customer\CustomerInc\mmi_rp_app_viewsetting_def.h	plutommi\mmi\setting\settingres\viewsetting.res
plutommi\Customer\CustomerInc\mmi_rp_app_webcam_def.h	plutommi\mtkapp\connectivity\connectivityres\webcam.res
plutommi\Customer\CustomerInc\mmi_rp_app_worldclock_def.h	plutommi\mmi\organizer\organizerres\worldclock\worldclock.res
plutommi\Customer\CustomerInc\mmi_rp_core_ucm_def.h	plutommi\appcore\ucm\res\ucmcore.res
plutommi\Customer\CustomerInc\mmi_rp_cui_alert_def.h	plutommi\framework\commonscreens\commonscreensres\alert.res
plutommi\Customer\CustomerInc\mmi_rp_cui_dialer_def.h	plutommi\cui\dialercui\res\dialercui.res
plutommi\Customer\CustomerInc\mmi_rp_cui_imageviewer_def.h	plutommi\cui\imageviewcui\res\imgviewcui.res
plutommi\Customer\CustomerInc\mmi_rp_cui_password_def.h	plutommi\cui\passwordcui\res\passwordcui.res
plutommi\Customer\CustomerInc\mmi_rp_cui_sim_sel_def.h	plutommi\cui\simselcui\res\simselcui.res
plutommi\Customer\CustomerInc\mmi_rp_cui_sso_def.h	plutommi\cui\ssocui\ssocuires\ssocui.res
plutommi\Customer\CustomerInc\mmi_rp_cui_toneselector_def.h	plutommi\cui\toneselectorcui\res\toneselectorcui.res
plutommi\Customer\CustomerInc\mmi_rp_cui_use_detail_def.h	plutommi\cui\usedetailcui\res\usedetailcui.res
plutommi\Customer\CustomerInc\mmi_rp_cui_verify_def.h	plutommi\cui\secsetcui\secsetcuires\secsetcui.res
plutommi\Customer\CustomerInc\mmi_rp_framework_asm_def.h	plutommi\framework\memmanager\memmanagerres\framework_asm.res
plutommi\Customer\CustomerInc\mmi_rp_motion_sensor_def.h	plutommi\mmi\setting\settingres\motionsensor.res
plutommi\Customer\CustomerInc\mmi_rp_srv_alarm_def.h	plutommi\service\alarmsrv\res\alarmsrv.res
plutommi\Customer\CustomerInc\mmi_rp_srv_appmgr_def.h	plutommi\service\appmgrsrv\appmgrsrvres\appmgrsrv.res
plutommi\Customer\CustomerInc\mmi_rp_srv_bootup_def.h	plutommi\service\bootupsrv\bootupsrvres\bootupsrv.res
plutommi\Customer\CustomerInc\mmi_rp_srv_btcm_def.h	plutommi\service\btcmsrv\res\btcmsrv.res
plutommi\Customer\CustomerInc\mmi_rp_srv_calllog_def.h	plutommi\service\calllogsrv\calllogsrvres\calllogsrv.res
plutommi\Customer\CustomerInc\mmi_rp_srv_callset_def.h	plutommi\service\callsetsrv\callsetsrv.res
plutommi\Customer\CustomerInc\mmi_rp_srv_cbm_def.h	plutommi\service\cbmsrv\res\cbmsrv.res
plutommi\Customer\CustomerInc\mmi_rp_srv_charbat_def.h	plutommi\service\charbatsrv\chargersrv.res
plutommi\Customer\CustomerInc\mmi_rp_srv_cnmgr_def.h	plutommi\service\cnmgrsrv\cnmgrsrvres\cnmgrsrv.res
plutommi\Customer\CustomerInc\mmi_rp_srv_cphs_def.h	plutommi\service\cphssrv\cphssrv.res
plutommi\Customer\CustomerInc\mmi_rp_srv_datalock_def.h	plutommi\service\datalocksrv\res\datalocksrv.res
plutommi\Customer\CustomerInc\mmi_rp_srv_datetime_def.h	plutommi\mmi\datetime\res\datetime.res
plutommi\Customer\CustomerInc\mmi_rp_srv_dtcnt_def.h	plutommi\service\dtcntsrv\dtcntsrvres\dtcntsrv.res
plutommi\Customer\CustomerInc\mmi_rp_srv_editor_def.h	plutommi\framework\commonscreens\commonscreensres\editor.res
plutommi\Customer\CustomerInc\mmi_rp_srv_filemanager_def.h	plutommi\service\filemgrsrv\filemgrsrvres\filemgrsrv.res
plutommi\Customer\CustomerInc\mmi_rp_srv_flight_mode_def.h	plutommi\mmi\setting\settingres\flightmode.res
plutommi\Customer\CustomerInc\mmi_rp_srv_fullscreen_editor_def.h	plutommi\cui\fseditorcui\fseditorcui_res\fseditorcui.res
plutommi\Customer\CustomerInc\mmi_rp_srv_gcall_def.h	plutommi\service\gsm3gcallsrv\gcallsrv.res
plutommi\Customer\CustomerInc\mmi_rp_srv_gdi_def.h	plutommi\framework\gdi\gdires\gdi_timer.res
plutommi\Customer\CustomerInc\mmi_rp_srv_general_setting_def.h	plutommi\service\settingsrv\res\generalsettingsrv.res
plutommi\Customer\CustomerInc\mmi_rp_srv_gpio_def.h	plutommi\service\gpiosrv\gpiosrv.res
plutommi\Customer\CustomerInc\mmi_rp_srv_gps_def.h	plutommi\mtkapp\gps\gpsres\gpsres.res
plutommi\Customer\CustomerInc\mmi_rp_srv_inline_editor_def.h	plutommi\cui\inlinecui\inlinecui_res\inlinecui.res
plutommi\Customer\CustomerInc\mmi_rp_srv_input_method_def.h	plutommi\framework\inputmethod\res\input_method.res
plutommi\Customer\CustomerInc\mmi_rp_srv_mdi_aud_info_def.h	plutommi\service\mdi\mdires\mdi_mem.res
plutommi\Customer\CustomerInc\mmi_rp_srv_mdi_audply_def.h	plutommi\service\mdi\mdires\mdi_mem.res
plutommi\Customer\CustomerInc\mmi_rp_srv_mdi_def.h	plutommi\service\mdi\mdires\mdi.res
plutommi\Customer\CustomerInc\mmi_rp_srv_mmi_charset_def.h	custom\common\charsetres\charset.res
plutommi\Customer\CustomerInc\mmi_rp_srv_mmi_theme_def.h	plutommi\mmi\setting\settingres\mmithemes.res
plutommi\Customer\CustomerInc\mmi_rp_srv_modeswitch_def.h	plutommi\service\modeswitchsrv\res\modeswitchsrv.res
plutommi\Customer\CustomerInc\mmi_rp_srv_netset_def.h	plutommi\service\netsetsrv\res\netsetsrv.res
plutommi\Customer\CustomerInc\mmi_rp_srv_nitz_def.h	plutommi\service\nitzsrv\res\nitzsrv.res
plutommi\Customer\CustomerInc\mmi_rp_srv_nmgr_def.h	plutommi\framework\notification\notificationres\nmgr.res
plutommi\Customer\CustomerInc\mmi_rp_srv_nss_def.h	plutommi\service\notificationsettingsrv\notificationsettingsrv.res
plutommi\Customer\CustomerInc\mmi_rp_srv_nw_info_def.h	plutommi\service\nwinfosrv\nwinfosrvres\nwinfosrv.res
plutommi\Customer\CustomerInc\mmi_rp_srv_nw_name_def.h	plutommi\service\nwnamesrv\res\nwnamesrv.res
plutommi\Customer\CustomerInc\mmi_rp_srv_pen_calibration_def.h	plutommi\service\settingsrv\res\pencalibrationsrv.res
plutommi\Customer\CustomerInc\mmi_rp_srv_phb_def.h	plutommi\service\phbsrv\phbsrvres\phbsrv.res
plutommi\Customer\CustomerInc\mmi_rp_srv_phnset_onoff_def.h	plutommi\mmi\setting\settingres\poweronoffdisplay.res
plutommi\Customer\CustomerInc\mmi_rp_srv_pns_def.h	plutommi\service\pnsrv\pnsrv.res
plutommi\Customer\CustomerInc\mmi_rp_srv_prof_def.h	plutommi\service\profilessrv\profilessrvres\profilessrv.res
plutommi\Customer\CustomerInc\mmi_rp_srv_reminder_def.h	plutommi\service\remindersrv\remindersrvres\remindersrv.res
plutommi\Customer\CustomerInc\mmi_rp_srv_restore_def.h	plutommi\service\settingsrv\res\restoresrv.res
plutommi\Customer\CustomerInc\mmi_rp_srv_safe_mode_def.h	plutommi\service\safemodesrv\res\safemodesrv.res
plutommi\Customer\CustomerInc\mmi_rp_srv_sat_def.h	plutommi\service\satsrv\sat.res
plutommi\Customer\CustomerInc\mmi_rp_srv_screensaver_def.h	plutommi\mmi\setting\settingres\screensaver.res
plutommi\Customer\CustomerInc\mmi_rp_srv_secset_def.h	plutommi\service\secsetsrv\secsetsrvres\secsetsrv.res
plutommi\Customer\CustomerInc\mmi_rp_srv_sensor_def.h	plutommi\service\sensorsrv\sensorsrv.res
plutommi\Customer\CustomerInc\mmi_rp_srv_shutdown_def.h	plutommi\service\shutdownsrv\shutdownsrvres\shutdownsrv.res
plutommi\Customer\CustomerInc\mmi_rp_srv_sim_ctrl_def.h	plutommi\service\simctrlsrv\simctrlsrvres\simctrlsrv.res
plutommi\Customer\CustomerInc\mmi_rp_srv_sms_def.h	plutommi\service\smssrv\smssrv.res
plutommi\Customer\CustomerInc\mmi_rp_srv_soundrec_def.h	plutommi\service\soundrecsrv\res\soundrecsrv.res
plutommi\Customer\CustomerInc\mmi_rp_srv_spof_def.h	plutommi\mmi\setting\settingres\schedulepoweronoff.res
plutommi\Customer\CustomerInc\mmi_rp_srv_ss_def.h	plutommi\service\sssrv\sssrv.res
plutommi\Customer\CustomerInc\mmi_rp_srv_status_icons_def.h	plutommi\framework\gui\gui_res\status_icon_bar.res
plutommi\Customer\CustomerInc\mmi_rp_srv_syncml_def.h	plutommi\mtkapp\syncml\syncmlres\syncml.res
plutommi\Customer\CustomerInc\mmi_rp_srv_ucm_def.h	plutommi\service\ucmsrv\ucmsrvres\ucmsrv.res
plutommi\Customer\CustomerInc\mmi_rp_srv_unifiedmessage_def.h	plutommi\service\umsrv\umsrvres\umsrv.res
plutommi\Customer\CustomerInc\mmi_rp_srv_vbookmark_def.h	plutommi\mtkapp\vobjects\vobjectres\vbookmark.res
plutommi\Customer\CustomerInc\mmi_rp_srv_vcalendar_def.h	plutommi\mtkapp\vobjects\vobjectres\vcalendar.res
plutommi\Customer\CustomerInc\mmi_rp_srv_vcard_def.h	plutommi\mtkapp\vobjects\vobjectres\vcard.res
plutommi\Customer\CustomerInc\mmi_rp_srv_venus_component_normal_mode_menu_def.h	venusmmi\visual\cp\res\vcp_normal_mode_menu.res
plutommi\Customer\CustomerInc\mmi_rp_srv_venus_theme_def.h	plutommi\mmi\resource\res\venustheme.res
plutommi\Customer\CustomerInc\mmi_rp_srv_virtual_keyboard_misc_def.h	plutommi\framework\gui\gui_res\virtual_keyboard_misc.res
plutommi\Customer\CustomerInc\mmi_rp_srv_vk3_def.h	plutommi\Customer\ResGenerator\ResgenVk3\vkv3_resgen_main.py
plutommi\Customer\CustomerInc\mmi_rp_srv_vobject_def.h	plutommi\mtkapp\vobjects\vobjectres\vobjects.res
plutommi\Customer\CustomerInc\mmi_rp_srv_wallpaper_def.h	plutommi\mmi\setting\settingres\wallpaper.res
plutommi\Customer\CustomerInc\mmi_rp_srv_wgtmgr_def.h	plutommi\service\wgtmgrsrv\wgtmgrsrvres\wgtmgrsrv.res
plutommi\Customer\CustomerInc\mmi_rp_vapp_video_player_cp_def.h	venusmmi\app\common\cp\res\vapp_video_player_cp.res
plutommi\Customer\ResGenerator\debug\res\mmi_rp_app_alarm.c	plutommi\mmi\organizer\organizerres\alarmres\alarm.res
plutommi\Customer\ResGenerator\debug\res\mmi_rp_app_am.c	plutommi\mtkapp\mreapp\mreappres\am_int.res
plutommi\Customer\ResGenerator\debug\res\mmi_rp_app_apn_control.c	plutommi\mmi\setting\settingres\apncontrol.res
plutommi\Customer\ResGenerator\debug\res\mmi_rp_app_appmgr_test_1.c	plutommi\service\nativeappfactorysrv\nativeappfactorysrvres\app_appmgr_test_1.res
plutommi\Customer\ResGenerator\debug\res\mmi_rp_app_appmgr_test_2.c	app_appmgr_test_2.res
plutommi\Customer\ResGenerator\debug\res\mmi_rp_app_appmgr_test_3.c	app_appmgr_test_3.res
plutommi\Customer\ResGenerator\debug\res\mmi_rp_app_appmgr_test_4.c	app_appmgr_test_4.res
plutommi\Customer\ResGenerator\debug\res\mmi_rp_app_audioplayer.c	plutommi\mtkapp\audioplayer\audioplayerres\audioplayer.res
plutommi\Customer\ResGenerator\debug\res\mmi_rp_app_auto_rotate.c	screenrotation.res
plutommi\Customer\ResGenerator\debug\res\mmi_rp_app_bluetooth.c	plutommi\mtkapp\connectivity\connectivityres\bluetooth\bluetooth.res
plutommi\Customer\ResGenerator\debug\res\mmi_rp_app_bootup.c	plutommi\mmi\bootup\bootupres\bootup.res
plutommi\Customer\ResGenerator\debug\res\mmi_rp_app_bt_dialer.c	plutommi\mtkapp\btdialer\btdialerres\btdialer.res
plutommi\Customer\ResGenerator\debug\res\mmi_rp_app_calculator.c	plutommi\mmi\extra\extrares\calculator.res
plutommi\Customer\ResGenerator\debug\res\mmi_rp_app_calendar.c	plutommi\mmi\organizer\organizerres\calendar.res
plutommi\Customer\ResGenerator\debug\res\mmi_rp_app_calibration.c	plutommi\mmi\setting\settingres\pencalibration\calibration.res
plutommi\Customer\ResGenerator\debug\res\mmi_rp_app_calllog.c	plutommi\mmi\calllog\calllogres\calllog.res
plutommi\Customer\ResGenerator\debug\res\mmi_rp_app_callset.c	plutommi\mmi\callsetting\callsettingres\callset.res
plutommi\Customer\ResGenerator\debug\res\mmi_rp_app_camco.c	plutommi\mtkapp\camcorder\camcorderres\camcorder.res
plutommi\Customer\ResGenerator\debug\res\mmi_rp_app_camera.c	plutommi\mtkapp\camera\camerares\camerares.res
plutommi\Customer\ResGenerator\debug\res\mmi_rp_app_cb_mgr.c	plutommi\framework\callbackmanager\callbackmanagerres\callback_mgr.res
plutommi\Customer\ResGenerator\debug\res\mmi_rp_app_cbm.c	plutommi\mmi\cbm\cbmres\cbm.res
plutommi\Customer\ResGenerator\debug\res\mmi_rp_app_charger.c	plutommi\mmi\miscframework\miscframeworkres\chargerapp.res
plutommi\Customer\ResGenerator\debug\res\mmi_rp_app_connectivity_mainmenu.c	plutommi\mtkapp\connectivity\connectivityres\connectivitymainmenu.res
plutommi\Customer\ResGenerator\debug\res\mmi_rp_app_customer_service.c	plutommi\mmi\customerservice\customerserviceres\customerservice.res
plutommi\Customer\ResGenerator\debug\res\mmi_rp_app_dataaccount.c	plutommi\mmi\dataaccount\dataaccountres\dataaccount.res
plutommi\Customer\ResGenerator\debug\res\mmi_rp_app_devapp.c	plutommi\vendorapp\devapp\devappres\devapp.res
plutommi\Customer\ResGenerator\debug\res\mmi_rp_app_dialer.c	plutommi\mmi\dialer\dialerres\dialer.res
plutommi\Customer\ResGenerator\debug\res\mmi_rp_app_engineermode1.c	plutommi\mtkapp\engineermode\engineermodeapp\engineermodeappres\engineermode.res
plutommi\Customer\ResGenerator\debug\res\mmi_rp_app_extra.c	plutommi\mmi\extra\extrares\extra.res
plutommi\Customer\ResGenerator\debug\res\mmi_rp_app_factorymode.c	plutommi\mtkapp\factorymode\factorymoderes\factorymode.res
plutommi\Customer\ResGenerator\debug\res\mmi_rp_app_filemanager.c	plutommi\mtkapp\filemgr\filemgrres\000_filemgr.res
plutommi\Customer\ResGenerator\debug\res\mmi_rp_app_font_effects.c	plutommi\mmi\miscframework\miscframeworkres\fonteffects.res
plutommi\Customer\ResGenerator\debug\res\mmi_rp_app_font_manager.c	plutommi\mmi\miscframework\miscframeworkres\fontmanager.res
plutommi\Customer\ResGenerator\debug\res\mmi_rp_app_funandgames.c	plutommi\mmi\funandgames\funandgamesres\fanandgame.res
plutommi\Customer\ResGenerator\debug\res\mmi_rp_app_gpio.c	plutommi\mmi\gpio\gpiores\phnsetgpio.res
plutommi\Customer\ResGenerator\debug\res\mmi_rp_app_idle.c	plutommi\mmi\idle\idleres\idle.res
plutommi\Customer\ResGenerator\debug\res\mmi_rp_app_idle_homescreen.c	plutommi\mmi\idlescreen\idlescreenres\idlehomescreen.res
plutommi\Customer\ResGenerator\debug\res\mmi_rp_app_idle_nmgr.c	plutommi\mmi\idlescreen\idlescreenres\idlenotificationmanager.res
plutommi\Customer\ResGenerator\debug\res\mmi_rp_app_imageflow.c	venusmmi\app\pluto_variation\imageflow\res\imageflow.res
plutommi\Customer\ResGenerator\debug\res\mmi_rp_app_imageviewer.c	plutommi\mtkapp\imageview\imageviewres\imgview.res
plutommi\Customer\ResGenerator\debug\res\mmi_rp_app_lunar_query.c	plutommi\mmi\organizer\organizerres\lunarquery.res
plutommi\Customer\ResGenerator\debug\res\mmi_rp_app_mainmenu.c	plutommi\mmi\mainmenu\mainmenures\mainmenures.res
plutommi\Customer\ResGenerator\debug\res\mmi_rp_app_mediawall.c	venusmmi\app\pluto_variation\mediawall\res\mediawall.res
plutommi\Customer\ResGenerator\debug\res\mmi_rp_app_mmi_certman.c	plutommi\mmi\certificatemanager\certificatemanagerres\certificatemanager.res
plutommi\Customer\ResGenerator\debug\res\mmi_rp_app_mobile_service.c	plutommi\mmi\mobileservice\mobileserviceres\mobileservice.res
plutommi\Customer\ResGenerator\debug\res\mmi_rp_app_mode_switch.c	plutommi\mmi\setting\settingres\modeswitch.res
plutommi\Customer\ResGenerator\debug\res\mmi_rp_app_mre.c	mre\res\mre.res
plutommi\Customer\ResGenerator\debug\res\mmi_rp_app_mre_appmgr.c	plutommi\service\mreappmgrsrv\mreappmgrsrvres\mreappmgrsrv.res
plutommi\Customer\ResGenerator\debug\res\mmi_rp_app_mre_bg.c	mre\res\mre_bg.res
plutommi\Customer\ResGenerator\debug\res\mmi_rp_app_mspace.c	plutommi\mtkapp\mspace\mspaceres\mspace.res
plutommi\Customer\ResGenerator\debug\res\mmi_rp_app_netset.c	plutommi\mmi\setting\settingres\netsetapp.res
plutommi\Customer\ResGenerator\debug\res\mmi_rp_app_nitz.c	plutommi\mmi\nitzhandler\nitzres\nitz.res
plutommi\Customer\ResGenerator\debug\res\mmi_rp_app_note.c	plutommi\mmi\organizer\organizerres\note.res
plutommi\Customer\ResGenerator\debug\res\mmi_rp_app_nss.c	plutommi\mmi\setting\settingres\nssapp.res
plutommi\Customer\ResGenerator\debug\res\mmi_rp_app_ntp.c	plutommi\mmi\setting\settingres\ntpapp.res
plutommi\Customer\ResGenerator\debug\res\mmi_rp_app_nw_info.c	plutommi\mmi\nwinfo\nwinfores\nwinfo.res
plutommi\Customer\ResGenerator\debug\res\mmi_rp_app_organizer.c	plutommi\mmi\organizer\organizerres\organizer.res
plutommi\Customer\ResGenerator\debug\res\mmi_rp_app_package_concurrent.c	plutommi\mmi\inc\app_package_concurrent.res
plutommi\Customer\ResGenerator\debug\res\mmi_rp_app_phonebook.c	plutommi\mmi\phonebook\phonebookres\phonebook.res
plutommi\Customer\ResGenerator\debug\res\mmi_rp_app_phonesetting_new.c	plutommi\mmi\setting\settingres\phonesetting.res
plutommi\Customer\ResGenerator\debug\res\mmi_rp_app_profiles.c	plutommi\mmi\profiles\profiles_res\profiles.res
plutommi\Customer\ResGenerator\debug\res\mmi_rp_app_reminder.c	plutommi\mmi\organizer\reminder\res\reminder.res
plutommi\Customer\ResGenerator\debug\res\mmi_rp_app_restore.c	plutommi\mmi\setting\settingres\restore.res
plutommi\Customer\ResGenerator\debug\res\mmi_rp_app_sat.c	plutommi\mmi\sat\satres\satapp.res
plutommi\Customer\ResGenerator\debug\res\mmi_rp_app_scr_locker.c	plutommi\mmi\scrlocker\scrlockerres\scrlocker.res
plutommi\Customer\ResGenerator\debug\res\mmi_rp_app_search_web.c	plutommi\mtkapp\searchweb\searchwebres\searchweb.res
plutommi\Customer\ResGenerator\debug\res\mmi_rp_app_security_setting.c	plutommi\mmi\securitysetting\secsetres\secset.res
plutommi\Customer\ResGenerator\debug\res\mmi_rp_app_services_sat.c	plutommi\mmi\sat\satres\service.res
plutommi\Customer\ResGenerator\debug\res\mmi_rp_app_setting_download_cal_data.c	plutommi\mmi\setting\settingres\downloadcaldata.res
plutommi\Customer\ResGenerator\debug\res\mmi_rp_app_setting_menu_effect.c	plutommi\mmi\setting\settingres\menueffect.res
plutommi\Customer\ResGenerator\debug\res\mmi_rp_app_setting_new.c	plutommi\mmi\setting\settingres\appsetting.res
plutommi\Customer\ResGenerator\debug\res\mmi_rp_app_setting_version.c	plutommi\mmi\setting\settingres\version.res
plutommi\Customer\ResGenerator\debug\res\mmi_rp_app_shellapp_base.c	venusmmi\app\pluto_variation\shellapp\base\res\shellappbase.res
plutommi\Customer\ResGenerator\debug\res\mmi_rp_app_shortcuts.c	plutommi\mmi\extra\extrares\shortcuts.res
plutommi\Customer\ResGenerator\debug\res\mmi_rp_app_shutdown.c	plutommi\mmi\shutdown\shutdownres\shutdown.res
plutommi\Customer\ResGenerator\debug\res\mmi_rp_app_sim_ctrl.c	plutommi\mmi\simctrl\simctrlres\simctrl.res
plutommi\Customer\ResGenerator\debug\res\mmi_rp_app_simspace.c	plutommi\mmi\simspace\simspaceres\simspace.res
plutommi\Customer\ResGenerator\debug\res\mmi_rp_app_sms.c	plutommi\mmi\messages\messagesres\smsappres.res
plutommi\Customer\ResGenerator\debug\res\mmi_rp_app_soundrecorder.c	plutommi\mtkapp\sndrec\sndrecres\sndrec.res
plutommi\Customer\ResGenerator\debug\res\mmi_rp_app_ss.c	plutommi\mmi\supplementaryservice\ssres\ss.res
plutommi\Customer\ResGenerator\debug\res\mmi_rp_app_sso.c	plutommi\mmi\ssoapp\ssoappres\ssoapp.res
plutommi\Customer\ResGenerator\debug\res\mmi_rp_app_syncml.c	plutommi\mtkapp\syncml\syncmlres\syncmldevice.res
plutommi\Customer\ResGenerator\debug\res\mmi_rp_app_todolist.c	plutommi\mmi\organizer\organizerres\todolist.res
plutommi\Customer\ResGenerator\debug\res\mmi_rp_app_tts_setting.c	plutommi\mmi\setting\settingres\ttssetting.res
plutommi\Customer\ResGenerator\debug\res\mmi_rp_app_ucm.c	plutommi\mmi\ucm\ucmres\ucm.res
plutommi\Customer\ResGenerator\debug\res\mmi_rp_app_ucmbt.c	plutommi\mmi\bt_ucm\ucmbtres\ucmbt.res
plutommi\Customer\ResGenerator\debug\res\mmi_rp_app_udx.c	plutommi\mmi\udx\udxres\udx.res
plutommi\Customer\ResGenerator\debug\res\mmi_rp_app_uiframework.c	plutommi\framework\gui\gui_res\gui.res
plutommi\Customer\ResGenerator\debug\res\mmi_rp_app_unifiedmessage.c	plutommi\mmi\unifiedmessage\unifiedmessageres\unifiedmessage.res
plutommi\Customer\ResGenerator\debug\res\mmi_rp_app_usbmmi.c	plutommi\mtkapp\connectivity\connectivityres\usb\usbmmi.res
plutommi\Customer\ResGenerator\debug\res\mmi_rp_app_usbsrv.c	plutommi\service\usbsrv\usbsrvres\usbsrv.res
plutommi\Customer\ResGenerator\debug\res\mmi_rp_app_vdorec.c	plutommi\mtkapp\video\videores\vdorecres.res
plutommi\Customer\ResGenerator\debug\res\mmi_rp_app_venus_homescreen.c	venusmmi\app\pluto_variation\shellapp\panel\homescreen\res\vapp_hs.res
plutommi\Customer\ResGenerator\debug\res\mmi_rp_app_venus_homescreen_wg_audioplayer.c	venusmmi\app\pluto_variation\shellapp\panel\homescreen\res\vapp_hs_widget_audplayer.res
plutommi\Customer\ResGenerator\debug\res\mmi_rp_app_venus_homescreen_wg_calendar.c	venusmmi\app\pluto_variation\shellapp\panel\homescreen\res\vapp_hs_widget_calendar.res
plutommi\Customer\ResGenerator\debug\res\mmi_rp_app_venus_homescreen_wg_clock.c	venusmmi\app\pluto_variation\shellapp\panel\homescreen\res\vapp_hs_widget_clock.res
plutommi\Customer\ResGenerator\debug\res\mmi_rp_app_venus_homescreen_wg_date.c	venusmmi\app\pluto_variation\shellapp\panel\homescreen\res\vapp_hs_widget_date.res
plutommi\Customer\ResGenerator\debug\res\mmi_rp_app_venus_homescreen_wg_event_inbox.c	venusmmi\app\pluto_variation\shellapp\panel\homescreen\res\vapp_hs_widget_event_inbox.res
plutommi\Customer\ResGenerator\debug\res\mmi_rp_app_venus_homescreen_wg_fmradio.c	venusmmi\app\pluto_variation\shellapp\panel\homescreen\res\vapp_hs_widget_fmradio.res
plutommi\Customer\ResGenerator\debug\res\mmi_rp_app_venus_homescreen_wg_memo.c	venusmmi\app\pluto_variation\shellapp\panel\homescreen\res\vapp_hs_widget_memo.res
plutommi\Customer\ResGenerator\debug\res\mmi_rp_app_venus_homescreen_wg_mobile_internet.c	venusmmi\app\pluto_variation\shellapp\panel\homescreen\res\vapp_hs_widget_op02.res
plutommi\Customer\ResGenerator\debug\res\mmi_rp_app_venus_homescreen_wg_mre.c	venusmmi\app\pluto_variation\shellapp\panel\homescreen\res\vapp_hs_widget_mre.res
plutommi\Customer\ResGenerator\debug\res\mmi_rp_app_venus_homescreen_wg_next_alarm.c	venusmmi\app\pluto_variation\shellapp\panel\homescreen\res\vapp_hs_widget_next_alarm.res
plutommi\Customer\ResGenerator\debug\res\mmi_rp_app_venus_homescreen_wg_operator_name.c	venusmmi\app\pluto_variation\shellapp\panel\homescreen\res\vapp_hs_widget_operator_name.res
plutommi\Customer\ResGenerator\debug\res\mmi_rp_app_venus_homescreen_wg_pet.c	venusmmi\app\pluto_variation\shellapp\panel\homescreen\res\vapp_hs_widget_pet.res
plutommi\Customer\ResGenerator\debug\res\mmi_rp_app_venus_homescreen_wg_photo.c	venusmmi\app\pluto_variation\shellapp\panel\homescreen\res\vapp_hs_widget_photo.res
plutommi\Customer\ResGenerator\debug\res\mmi_rp_app_venus_homescreen_wg_profile.c	venusmmi\app\pluto_variation\shellapp\panel\homescreen\res\vapp_hs_widget_profile.res
plutommi\Customer\ResGenerator\debug\res\mmi_rp_app_venus_homescreen_wg_snow.c	venusmmi\app\pluto_variation\shellapp\panel\homescreen\res\vapp_hs_widget_snow.res
plutommi\Customer\ResGenerator\debug\res\mmi_rp_app_venus_homescreen_wg_wo_store.c	venusmmi\app\pluto_variation\shellapp\panel\homescreen\res\vapp_hs_widget_op02.res
plutommi\Customer\ResGenerator\debug\res\mmi_rp_app_venus_hs_todo.c	venusmmi\app\pluto_variation\shellapp\panel\homescreen\res\vapp_hs_widget_todo.res
plutommi\Customer\ResGenerator\debug\res\mmi_rp_app_venus_hs_wg_baidu.c	venusmmi\app\pluto_variation\shellapp\panel\homescreen\res\vapp_hs_widget_baidu.res
plutommi\Customer\ResGenerator\debug\res\mmi_rp_app_venus_hs_wg_bkm.c	venusmmi\app\pluto_variation\shellapp\panel\homescreen\res\vapp_hs_widget_bookmark.res
plutommi\Customer\ResGenerator\debug\res\mmi_rp_app_venus_notepaper.c	venusmmi\app\pluto_variation\shellapp\panel\msgviewer\res\vapp_notepaper.res
plutommi\Customer\ResGenerator\debug\res\mmi_rp_app_venus_shell_fc.c	venusmmi\app\pluto_variation\shellapp\panel\favoritecontacts\res\vapp_shell_fc.res
plutommi\Customer\ResGenerator\debug\res\mmi_rp_app_venus_shell_iv.c	venusmmi\app\pluto_variation\shellapp\panel\imageviewer\res\shellimageviewer.res
plutommi\Customer\ResGenerator\debug\res\mmi_rp_app_venus_shell_mediaplayer.c	venusmmi\app\pluto_variation\shellapp\panel\mediaplayer\vapp_shell_mediaplayer.res
plutommi\Customer\ResGenerator\debug\res\mmi_rp_app_venus_shell_msg_viewer.c	venusmmi\app\pluto_variation\shellapp\panel\msgviewer\res\vapp_shell_msg_viewer.res
plutommi\Customer\ResGenerator\debug\res\mmi_rp_app_venus_shell_scrlock.c	venusmmi\app\pluto_variation\shellapp\base\res\shellappscrlock.res
plutommi\Customer\ResGenerator\debug\res\mmi_rp_app_venus_shell_settings.c	venusmmi\app\pluto_variation\shellapp\panel\settings\vapp_shell_settings.res
plutommi\Customer\ResGenerator\debug\res\mmi_rp_app_viewsetting.c	plutommi\mmi\setting\settingres\viewsetting.res
plutommi\Customer\ResGenerator\debug\res\mmi_rp_app_webcam.c	plutommi\mtkapp\connectivity\connectivityres\webcam.res
plutommi\Customer\ResGenerator\debug\res\mmi_rp_app_worldclock.c	plutommi\mmi\organizer\organizerres\worldclock\worldclock.res
plutommi\Customer\ResGenerator\debug\res\mmi_rp_core_ucm.c	plutommi\appcore\ucm\res\ucmcore.res
plutommi\Customer\ResGenerator\debug\res\mmi_rp_cui_alert.c	plutommi\framework\commonscreens\commonscreensres\alert.res
plutommi\Customer\ResGenerator\debug\res\mmi_rp_cui_dialer.c	plutommi\cui\dialercui\res\dialercui.res
plutommi\Customer\ResGenerator\debug\res\mmi_rp_cui_imageviewer.c	plutommi\cui\imageviewcui\res\imgviewcui.res
plutommi\Customer\ResGenerator\debug\res\mmi_rp_cui_password.c	plutommi\cui\passwordcui\res\passwordcui.res
plutommi\Customer\ResGenerator\debug\res\mmi_rp_cui_sim_sel.c	plutommi\cui\simselcui\res\simselcui.res
plutommi\Customer\ResGenerator\debug\res\mmi_rp_cui_sso.c	plutommi\cui\ssocui\ssocuires\ssocui.res
plutommi\Customer\ResGenerator\debug\res\mmi_rp_cui_toneselector.c	plutommi\cui\toneselectorcui\res\toneselectorcui.res
plutommi\Customer\ResGenerator\debug\res\mmi_rp_cui_use_detail.c	plutommi\cui\usedetailcui\res\usedetailcui.res
plutommi\Customer\ResGenerator\debug\res\mmi_rp_cui_verify.c	plutommi\cui\secsetcui\secsetcuires\secsetcui.res
plutommi\Customer\ResGenerator\debug\res\mmi_rp_framework_asm.c	plutommi\framework\memmanager\memmanagerres\framework_asm.res
plutommi\Customer\ResGenerator\debug\res\mmi_rp_motion_sensor.c	plutommi\mmi\setting\settingres\motionsensor.res
plutommi\Customer\ResGenerator\debug\res\mmi_rp_srv_alarm.c	plutommi\service\alarmsrv\res\alarmsrv.res
plutommi\Customer\ResGenerator\debug\res\mmi_rp_srv_appmgr.c	plutommi\service\appmgrsrv\appmgrsrvres\appmgrsrv.res
plutommi\Customer\ResGenerator\debug\res\mmi_rp_srv_bootup.c	plutommi\service\bootupsrv\bootupsrvres\bootupsrv.res
plutommi\Customer\ResGenerator\debug\res\mmi_rp_srv_btcm.c	plutommi\service\btcmsrv\res\btcmsrv.res
plutommi\Customer\ResGenerator\debug\res\mmi_rp_srv_calllog.c	plutommi\service\calllogsrv\calllogsrvres\calllogsrv.res
plutommi\Customer\ResGenerator\debug\res\mmi_rp_srv_callset.c	plutommi\service\callsetsrv\callsetsrv.res
plutommi\Customer\ResGenerator\debug\res\mmi_rp_srv_cbm.c	plutommi\service\cbmsrv\res\cbmsrv.res
plutommi\Customer\ResGenerator\debug\res\mmi_rp_srv_charbat.c	plutommi\service\charbatsrv\chargersrv.res
plutommi\Customer\ResGenerator\debug\res\mmi_rp_srv_cnmgr.c	plutommi\service\cnmgrsrv\cnmgrsrvres\cnmgrsrv.res
plutommi\Customer\ResGenerator\debug\res\mmi_rp_srv_cphs.c	plutommi\service\cphssrv\cphssrv.res
plutommi\Customer\ResGenerator\debug\res\mmi_rp_srv_datalock.c	plutommi\service\datalocksrv\res\datalocksrv.res
plutommi\Customer\ResGenerator\debug\res\mmi_rp_srv_datetime.c	plutommi\mmi\datetime\res\datetime.res
plutommi\Customer\ResGenerator\debug\res\mmi_rp_srv_dtcnt.c	plutommi\service\dtcntsrv\dtcntsrvres\dtcntsrv.res
plutommi\Customer\ResGenerator\debug\res\mmi_rp_srv_editor.c	plutommi\framework\commonscreens\commonscreensres\editor.res
plutommi\Customer\ResGenerator\debug\res\mmi_rp_srv_filemanager.c	plutommi\service\filemgrsrv\filemgrsrvres\filemgrsrv.res
plutommi\Customer\ResGenerator\debug\res\mmi_rp_srv_flight_mode.c	plutommi\mmi\setting\settingres\flightmode.res
plutommi\Customer\ResGenerator\debug\res\mmi_rp_srv_fullscreen_editor.c	plutommi\cui\fseditorcui\fseditorcui_res\fseditorcui.res
plutommi\Customer\ResGenerator\debug\res\mmi_rp_srv_gcall.c	plutommi\service\gsm3gcallsrv\gcallsrv.res
plutommi\Customer\ResGenerator\debug\res\mmi_rp_srv_gdi.c	plutommi\framework\gdi\gdires\gdi_timer.res
plutommi\Customer\ResGenerator\debug\res\mmi_rp_srv_general_setting.c	plutommi\service\settingsrv\res\generalsettingsrv.res
plutommi\Customer\ResGenerator\debug\res\mmi_rp_srv_gpio.c	plutommi\service\gpiosrv\gpiosrv.res
plutommi\Customer\ResGenerator\debug\res\mmi_rp_srv_gps.c	plutommi\mtkapp\gps\gpsres\gpsres.res
plutommi\Customer\ResGenerator\debug\res\mmi_rp_srv_inline_editor.c	plutommi\cui\inlinecui\inlinecui_res\inlinecui.res
plutommi\Customer\ResGenerator\debug\res\mmi_rp_srv_input_method.c	plutommi\framework\inputmethod\res\input_method.res
plutommi\Customer\ResGenerator\debug\res\mmi_rp_srv_mdi.c	plutommi\service\mdi\mdires\mdi.res
plutommi\Customer\ResGenerator\debug\res\mmi_rp_srv_mdi_aud_info.c	plutommi\service\mdi\mdires\mdi_mem.res
plutommi\Customer\ResGenerator\debug\res\mmi_rp_srv_mdi_audply.c	plutommi\service\mdi\mdires\mdi_mem.res
plutommi\Customer\ResGenerator\debug\res\mmi_rp_srv_mmi_charset.c	custom\common\charsetres\charset.res
plutommi\Customer\ResGenerator\debug\res\mmi_rp_srv_mmi_theme.c	plutommi\mmi\setting\settingres\mmithemes.res
plutommi\Customer\ResGenerator\debug\res\mmi_rp_srv_modeswitch.c	plutommi\service\modeswitchsrv\res\modeswitchsrv.res
plutommi\Customer\ResGenerator\debug\res\mmi_rp_srv_netset.c	plutommi\service\netsetsrv\res\netsetsrv.res
plutommi\Customer\ResGenerator\debug\res\mmi_rp_srv_nitz.c	plutommi\service\nitzsrv\res\nitzsrv.res
plutommi\Customer\ResGenerator\debug\res\mmi_rp_srv_nmgr.c	plutommi\framework\notification\notificationres\nmgr.res
plutommi\Customer\ResGenerator\debug\res\mmi_rp_srv_nss.c	plutommi\service\notificationsettingsrv\notificationsettingsrv.res
plutommi\Customer\ResGenerator\debug\res\mmi_rp_srv_nw_info.c	plutommi\service\nwinfosrv\nwinfosrvres\nwinfosrv.res
plutommi\Customer\ResGenerator\debug\res\mmi_rp_srv_nw_name.c	plutommi\service\nwnamesrv\res\nwnamesrv.res
plutommi\Customer\ResGenerator\debug\res\mmi_rp_srv_pen_calibration.c	plutommi\service\settingsrv\res\pencalibrationsrv.res
plutommi\Customer\ResGenerator\debug\res\mmi_rp_srv_phb.c	plutommi\service\phbsrv\phbsrvres\phbsrv.res
plutommi\Customer\ResGenerator\debug\res\mmi_rp_srv_phnset_onoff.c	plutommi\mmi\setting\settingres\poweronoffdisplay.res
plutommi\Customer\ResGenerator\debug\res\mmi_rp_srv_pns.c	plutommi\service\pnsrv\pnsrv.res
plutommi\Customer\ResGenerator\debug\res\mmi_rp_srv_prof.c	plutommi\service\profilessrv\profilessrvres\profilessrv.res
plutommi\Customer\ResGenerator\debug\res\mmi_rp_srv_reminder.c	plutommi\service\remindersrv\remindersrvres\remindersrv.res
plutommi\Customer\ResGenerator\debug\res\mmi_rp_srv_restore.c	plutommi\service\settingsrv\res\restoresrv.res
plutommi\Customer\ResGenerator\debug\res\mmi_rp_srv_safe_mode.c	plutommi\service\safemodesrv\res\safemodesrv.res
plutommi\Customer\ResGenerator\debug\res\mmi_rp_srv_sat.c	plutommi\service\satsrv\sat.res
plutommi\Customer\ResGenerator\debug\res\mmi_rp_srv_screensaver.c	plutommi\mmi\setting\settingres\screensaver.res
plutommi\Customer\ResGenerator\debug\res\mmi_rp_srv_secset.c	plutommi\service\secsetsrv\secsetsrvres\secsetsrv.res
plutommi\Customer\ResGenerator\debug\res\mmi_rp_srv_sensor.c	plutommi\service\sensorsrv\sensorsrv.res
plutommi\Customer\ResGenerator\debug\res\mmi_rp_srv_shutdown.c	plutommi\service\shutdownsrv\shutdownsrvres\shutdownsrv.res
plutommi\Customer\ResGenerator\debug\res\mmi_rp_srv_sim_ctrl.c	plutommi\service\simctrlsrv\simctrlsrvres\simctrlsrv.res
plutommi\Customer\ResGenerator\debug\res\mmi_rp_srv_sms.c	plutommi\service\smssrv\smssrv.res
plutommi\Customer\ResGenerator\debug\res\mmi_rp_srv_soundrec.c	plutommi\service\soundrecsrv\res\soundrecsrv.res
plutommi\Customer\ResGenerator\debug\res\mmi_rp_srv_spof.c	plutommi\mmi\setting\settingres\schedulepoweronoff.res
plutommi\Customer\ResGenerator\debug\res\mmi_rp_srv_ss.c	plutommi\service\sssrv\sssrv.res
plutommi\Customer\ResGenerator\debug\res\mmi_rp_srv_status_icons.c	plutommi\framework\gui\gui_res\status_icon_bar.res
plutommi\Customer\ResGenerator\debug\res\mmi_rp_srv_syncml.c	plutommi\mtkapp\syncml\syncmlres\syncml.res
plutommi\Customer\ResGenerator\debug\res\mmi_rp_srv_ucm.c	plutommi\service\ucmsrv\ucmsrvres\ucmsrv.res
plutommi\Customer\ResGenerator\debug\res\mmi_rp_srv_unifiedmessage.c	plutommi\service\umsrv\umsrvres\umsrv.res
plutommi\Customer\ResGenerator\debug\res\mmi_rp_srv_vbookmark.c	plutommi\mtkapp\vobjects\vobjectres\vbookmark.res
plutommi\Customer\ResGenerator\debug\res\mmi_rp_srv_vcalendar.c	plutommi\mtkapp\vobjects\vobjectres\vcalendar.res
plutommi\Customer\ResGenerator\debug\res\mmi_rp_srv_vcard.c	plutommi\mtkapp\vobjects\vobjectres\vcard.res
plutommi\Customer\ResGenerator\debug\res\mmi_rp_srv_venus_component_normal_mode_menu.c	venusmmi\visual\cp\res\vcp_normal_mode_menu.res
plutommi\Customer\ResGenerator\debug\res\mmi_rp_srv_venus_theme.c	plutommi\mmi\resource\res\venustheme.res
plutommi\Customer\ResGenerator\debug\res\mmi_rp_srv_virtual_keyboard_misc.c	plutommi\framework\gui\gui_res\virtual_keyboard_misc.res
plutommi\Customer\ResGenerator\debug\res\mmi_rp_srv_vobject.c	plutommi\mtkapp\vobjects\vobjectres\vobjects.res
plutommi\Customer\ResGenerator\debug\res\mmi_rp_srv_wallpaper.c	plutommi\mmi\setting\settingres\wallpaper.res
plutommi\Customer\ResGenerator\debug\res\mmi_rp_srv_wgtmgr.c	plutommi\service\wgtmgrsrv\wgtmgrsrvres\wgtmgrsrv.res
plutommi\Customer\ResGenerator\debug\res\mmi_rp_vapp_video_player_cp.c	venusmmi\app\common\cp\res\vapp_video_player_cp.res
plutommi\Framework\EventHandling\EventsInc\mmi_menu_handlers.h	plutommi\Customer\ResGenerator\mtk_resgenerator.cpp
plutommi\Framework\MSLT\MSLTInc\mslt_modis.h	plutommi\Customer\ResGenerator\mslt_parse_info.pl
plutommi\Framework\MSLT\MSLTInc\mslt_table.h	plutommi\Customer\ResGenerator\mslt_parse_info.pl
plutommi\MMI\Inc\mmi_common_app_trc.h	plutommi\Customer\ResGenerator\res_parse_screen_id.pl
plutommi\MMI\Inc\mmi_conn_app_trc.h	plutommi\Customer\ResGenerator\res_parse_screen_id.pl
plutommi\MMI\Inc\mmi_inet_app_trc.h	plutommi\Customer\ResGenerator\res_parse_screen_id.pl
plutommi\MMI\Inc\mmi_media_app_trc.h	plutommi\Customer\ResGenerator\res_parse_screen_id.pl
plutommi\Service\vk3Srv\Res\VK3.res	plutommi\Customer\ResGenerator\ResgenVk3\vkv3_resgen_main.py
